################
#      @LGGGGV #
#  X           #
#         O    #
#              #
#              #
#      C       #
####           #
#S C#          #
####           #
#              #
#              #
#              #
#              #
#              #
################
