################
#X     @       #
# #            #
# #    C     # #
# #          # #
# #          # #
# #          # #
# #          # #
# #          # #
# #          # #
# #          # #
# #          # #
# #          # #
# ############ #
#              #
################