################
#XX    @ LLVVGG#
#XX          GG#
######    ######
#C#  #    #  C #
##           C #
#D#  #    #  C #
######    ######
# D  #    #CCCC#
#    #    OCSCC#
#    #    #CCCC#
######    ######
# S  #    #CCCC#
#    #    OCDCC#
#    #    #CCCC#
################
