################
#X             #
#X             #
#C##### #### # #
# #    @     # #
# #          # #
# #          # #
# #    S     # #
# #          # #
# #          # #
# #          # #
# #       C  # #
# #          # #
# ############ #
#              #
################