################
#X     @       #
#X             #
#C########## # #
# #          # #
# #          # #
# #          # #
# #          # #
# #          # #
# #        DD# #
# #       DDC# #
# #       DCC# #
# #       DCC# #
# ############ #
#              #
################