################
#C    V      XX#
#  #          X#
# #G    O  S   #
#    D         #
#          O   #
#     D  D   V #
#              #
#              #
#   D          #
#          #   #
#       #      #
#              #
#       #      #
#@            C#
################
