################
#      @       #
#  X           #
#         O    #
#              #
#              #
#              #
#              #
#D     C       #
#              #
#              #
#              #
#              #
#              #
#              #
################
