################
#X#    @       #
# #            #
# #          # #
# #          # #
# #          # #
# #          # #
# #          # #
# #          # #
# #          # #
# #          # #
# #          # #
# #          # #
# ############ #
#              #
################